43434111111111111111111111111113
1   3                          1
4   4                   1 2 3  3
1   3                          1
4   4   23232     1     3 4 1  3
1   3   4         1            1
4       4         1     2 3 4  3
1       4         1            1
4       4         1            3
131313134         1212121211   1
1                          1   3
2           12             3   1
1           34             1   3
2                          3   1
1       3         2121212121   3
1       1                      2
1       2                      4
1       1                      2
121212121       21212  41314   4
1       2       1   1  1   1   2
4       1       1   1  411 4   4
1       2       21212    1 1   2
4       1                4 4   4
1       2                141   2
4       1                      4
1       2                      2
4       12341234123412341234   4
1                              2
4                              4
1                              2
41414141414141414141414141414141

