1111111111111111131131131313333333323322222222222222422424244444444444444444444411111111111111111111111111111111111111111111111111111111111111111111111111111
1   11    111111                 33    222  22    22                               11                                                                       1
1 S 1  11  111           33       33    2          2 24224244    444444    44444    11                                                                      1
1   1  111 1    13      31333      3         22    2         44444    44 444   44    11                                                                     1
1  1111111 11    1     31   333    3       2222                44      444      44    1                                                                     1
1  1        11        13     33          232  22222             4                     1                                                                     1
1 11         11        3331  333     33233        222           4                     1111                                                                  1
1 1        1  111       13  333    33               2222       44       1       44                                                                          1
1 1        11   13            33333                    2        44     111      4     1111                                                                  1
1 11        11                   3            222      22               1       4   111                                                                     1
1  111       1          313                 222         2       444            44   1                                                                       1
11   1111    1         11 33               22     222 222      44 44          44   11     111                                                               1
111          11        3   333            322       222      444   44       444          11                                                                 1
11111      111111     11    33333        2222222            44       44   44444444     111                                                                  1
1111111111111111113113333333333333233323222222222222242242444444444444444444444444111111111111111111111111111111111111111111111111111111111111111111111111111
